11111111111111111111111111111111111111111111111111
1P000000000000000000000000000000000000000000000001
100100000101001000000100000011C0000000000001001001
101000000000000000000C0100000000000000000000111001
10001000001C00001000000000000000001010000100101001
10010000000000000010000010000100010000001000000101
10000000000000010000000001000000000000000010000001
10100001000000000000000010001000000000000100001101
10100000000001001000000110000011000000010000000001
10001000000001000000001000000000010000100000000001
10100000010000000000100000001000000000001000000001
100100010000000100100001000C000000000000000C000001
10100001000100000000000100000000000100000101001001
101010000000011000000000101000000001C0110000010001
1010001000000000100000C000000000010000010000000001
10101000000010000000000001010000000001000100000101
100000C001000010110C010C00000000000000000110000001
10000000000000010000010000011000100000001000000001
100000000000000000000000000000000000000000000000E1
11111111111111111111111111111111111111111111111111