111111111111111
1P00000C0000011
101110111011011
101000100010011
1010C010X010011
101000100010011
101110111011011
10000C0000C0011
111011111011101
100000000000E11
111111111111111
