11111111111
1P0C0C0C011
10111111001
1C0000C0C01
10111110001
1C0C000C001
111111111E1
11111111111
