111111111111111
1P0C0C0C0C0E011
111111111111111
