1111111
1P0C001
1111111
10001E1
1111111
