1111111
1P0CE01
1000001
1110110
1111111
