111111111
1P000E001
111111101
1C0000001
111110101
111111C11
111111111
