1111111
1P0CE01
100P001
1111111
