1111111111
100000C001
1001110001
10P00000E1
1111111111