1111111111
1P0000C001
1001110001
1X000000E1
1111111111