1111111111
1P0000C001
1011101001
1000000E01
1C01010001
1000C0C001
1111111111