11111111111111111111111111
100000000000000000000000P1
10000000000000000000000001
10000000000000000000000001
10000000000000000000000001
10000000000000000000000001
10000000000000000000000001
10000000000000000000000001
10000000000000000000000001
10000000000000000000000001
1000000000000000X000000001
10000000000000000000000001
10000000000000000000000001
10000000000000000000000001
10000000000000000000000001
10000000000000000000000001
10000000000000000000000001
10000000000000000000000001
10000000000000000000000001
10000000000000000000000001
100000X0000000000000000001
10000000000000000000000001
10000000000000000000000001
10000000000000000000000001
1000000000000000000X000001
10000000000000000000000001
10000000000000000000000001
1000000C000000000000000001
10000000000000000000000001
10000000000000000000000001
100000000000000000C0000001
10000000000000000000000001
10000000000000000000000001
10000000000000000000000001
10000000000000000000000001
10000000000000000000000001
10000000000000000000000001
10000000000000000000000001
10000000000000000000000001
10000000000000000000000001
10000000000000000000000001
10000000000000000000000001
10000000000000000000000001
10000000000000000000000001
10000000000000000000000001
10000000000000000000000001
10000000000000000000000001
10000000000000000000000001
1000000C000000000000000001
10000000000000000000000001
10000000000000000000000001
100000000000000000C0000001
1E000000000000000000000001
11111111111111111111111111