111111111111
1P0111011E11
101100011011
1011100C0001
101100111011
10C000100011
101111100001
1000000C0001
111111111111
