11111
100E1
1X001
10011
11011
1CP01
11111