1111111111111111111111111
1P0C00C00C00C00C000000001
1000000000000000000000001
1000000000000000000000001
1000000000000000000000001
1000000000000000000000001
1000000000000000000000001
100X0000X0000X0000X000001
1000000000000000000000001
1000000000000000000000001
1000000000000000000000001
1000000000000000000000001
1000000000000000000000001
10000000000000000000000E1
1111111111111111111111111
