11111111111111111111111111111111
1P000000000C000000000C0000000011
10111111111111111111111111111101
10100000000000000000000000000101
10101111111111111111111111110101
10000000000000C00000000000001011
10111111111111111111111111110101
10000000000000000000000000000001
11111111111111111111111111111E11
11111111111111111111111111111111
