11111
1P001
10C01
10C01
10C01
10C01
10C01
10C01
10C01
10C01
10001
1E001
11111
