11111111111111111111
1PCCCCCCCC0000000E11
11111111111111111111
